baadhi: some
ya : of 
waandamanaji: protesters
pinga: oppose
wanaoipinga: who are opposing-V
serikali: government-N
rush:throw
walirusha: threw-V
mawe: stones
na: and
mabomu: bombs
petroli: petrol
shambu:attack
kuwashambulia: attacked
polisi: police
kuwa: be
waliokuwa: who were
zuia: prevent
wanawazuia: were preventing
andaman:protest
kuandamana: to protest, march in protest
hadi: up to, towards
makao: building
bunge:parliament
ili: in order to
ingia:enter
kuingia: enter
robo: quarter
fainali: finals
hitajika: require
itahithitajika: it is required
kuichapa: to beat
mabao: goals, bao-SING,ma~
matatu: three
kwa: against, by means of means, by, versus, for
Wachimbaji: excavators, miners
migodi: mines, mgodi-SING,mi~
hao: those
walitumia: used
ngazi: ladder
iliyotupwa: thrown
ndani: inside
ya: of, for
mugodi: mine, SYN:mgodi
huo: that
kujinasua: escape, save oneself from 
siku: day
jumatatu: Monday-N
mwongoza: director
filamu: film
Uingereza: UK
alipata: received
tuzo:award
bora:best, good
ambayo:which
ilipata: receive, STEM:pat~ 
ushindi: victory, STEM:shind~
shinda: win, ^:shind~
mbili: two
utengenezaji: craftsmanship-N, production-N
mzuri: good, high quality, excellent
wa: of
na: and
ubunifu: creativity,  STEM: bun~
mavazi: costumes, clothes
katika: in, in the
taarifa: news, information
vyombo: vessels, media, channels, SING:chombo
shirika: organization
hilo: that
linasema: says
kuwa: that
abiria: passengers
wote: all
wako: are, SING:ako,yuko
kamati: committee
hiyo: that
itajumuisha: will involve
watu: people
kutoka:from
sekta:sector
mbali mbali: various, different, range of ~
ikiwemo: in addition to, including
utumbuizaji: entertainment
majeshi:armies, SING:jeshi
yamepambana: have dealt with, STEM:pambana-deal with
vikali: thoroughly;ADV
waasi: rebels:N
maeneo: regions
tofauti: different;ADJ
mji: town, city;N
kongamano: forum,congress;N
linasema: says;V
abiria: passengers;N
salama: safe;ADJ
lilidhamiria: intended to;N, STEM-dhamir~
kutafuta: look for;V
mbinu: ways, means
kulinda:protect;V
wanyamapori: wild animals;N
walio: who have, who are:PPRON*
hatari:danger;N
kuangamia: extinction, death
ni:it is
wakati:time,season;N
mgumu-hard, tough;ADJ
ambayo:which ;PRON
inaarifiwa: informed(that);V
shambulia:attack, #shambulia,shambuliwa;V
wahuni:criminals, SING:mhuni
kocha:coach
sema:say, STEM:sem~ 
itatamba:top,win ~V
dhidi-against #dhidi ya; PREP
operesheni: operation
okoa:save #ku~ ;V
chimba: dig
madini: precious stones, minerals
kwama:stick, #walio~ stuck
kwenye: in the
shimo la mgodi: mine
yasitishwa: put to a halt for a while, temporarily suspended
mwaka: one year
baada: after
kumuua: killed, STEM: u~ 
mpenzi:lover
wake:his/her -PPRON
amezungumzia:has talked about, discussed
majuto:regrets
na:and 
masikiti:sorrow
yake:his/her -PPRON
kuhusu-about
kifo:death
cha:of
mwanawe:child of
rais:president
wa: of
kusini:south 
huenda:may, will possibly
akashitakiwa: to be charged
kuendesha:driving,running stomach, as in diarrhoea
vibaya: severely, dangerously-ADJ 
gari:car,vehicle
kumuua: killed
mwanamke:woman
mmoja:one
hayati:late
aliacha:left
mali:property
yenye:which has -PPRON
thamani:value, worth -N
dola:dollar
milioni:million
nne:four
alisema:he said
igawanywe:divided
kati ya:between ;PREP,ADV
familia:family ;N
shule:school;N
chama:party, as in political group ;N

























